R 640 640
NO ./sprite/soul.xpm
SO ./sprite/wall.xpm
WE ./sprite/w.png
EA ./sprite/e.png
HUD ./sprite/hud.png

S1 ./sprite/d.png
S2 ./sprite/star.png
S3 ./sprite/barrel.png
F 137,222,255
C 172,116,48

111111111111111111111111
100000000000000000000001
100002010314121304000001
100000010011011100000001
1N0000000000000000000001
100000010011011100000001
100000011314121314000001
100000000000000000000001
111111111111111111111111