R 640 640
NO ./sprite/n.png
SO ./sprite/s.png
WE ./sprite/w.png
EA ./sprite/e.png

S ./sprite/d.png
F 137,222,255
C 172,116,48

    111                 111
    1N11111             121
    1000001             101111    
    1111101             100001    
        101             110001    
        101              10001    
    11111011             10001    
   110000001             10001    
   1001111111111111111111100011
   1100000000000000000000000001   
   1111111111111111111111111111