R 1920 1080
NO ./sprite/n.png
SO ./sprite/s.png
WE ./sprite/w.png
EA ./sprite/e.png

S ./sprite/d.png
F 137,222,255
C 172,116,48

        11111111111111111111
        10000000000000000001
        10000000000000000001
        10000000000000000001
1111111110000000000000000001
10000000000202020202020202011
10000000000000000000000000001
1000N000000202020202020202001
10000000000000000000000000001
10000000000202020202020202001
10000000000000000000000000001
10000001110000011100000000001
11110111 1110101 101111010001
11111111 1111111 111111111111