R 320 320
NO ./sprite/soul.xpm
SO ./sprite/wall.xpm
WE ./sprite/w.png
EA ./sprite/e.png

S ./sprite/d.png
F 137,222,255
C 172,116,48

        1111111111111111111111111
        1000000000110000000000001
        1111000001110000002000001
        100100N000000000000000001
111111111011000001110000000000001
100000000011000001110111111111111
11110111111111011100000010001
11110111111111011101010000001
11000000110101011100000010001
10002000000000001100000010001
10000000000000001101010010001
110000011101010111110111100111
11110111 1110101 101111010001
11111111 1111111 111111111111